####################
#    B#            #
# ### ###### #### ##
# ##  ##     #    ##
# ## ###### #### ###
#          ##      #
# ###### ###########
# ##              ##
# ###### ## ########
#        ##        #
####### ###### #####
#    ##      ##    #
# ## ###### ###### #
# ##          ##  ##
#### ######## ######
#          ##      #
# #### ######### ###
# ##   #          ##
# ## ############ ##
#A   ############  #
####################

